# Map
  ww   ww   www                                                 
  ww   wwg  www                    ww                w     ww   
  ww    rww                        ww                      ww   
  grw          w                   ww        ww            ww   
 w              g www            www                       gr   
 w               rwwwww  ww    www    w                    ww   
 w            w    wwww  ww     w                    www  www   
              w    www                                    www   
 w        ww       w                      ww              www   
 w       www                              ww                    
 w       www            w     w        w     w                  
       ww               w w   w        w                        
     wwww      wg       wgw                     www w           
               w w  w     www           ww     wwww w           
                   ww          wwgwwww         ww  rw        w  
   ww                     ww   ww wwww                       w  
  www wwww        wwww    ww   wwrwwww                ww        
         w        wwww     ww                         ww        
        gw        wwww           ww                   ww        
   w   wr wwww                   wwww          wr               
   ww  w        www   bbbbyyyy    www      www www    ww        
   ww           www   bbbbyyyy    www      www gw     ww        
   ww           www                                   ww        
                wwwww                   www        www          
                   ww  ww        www      w    wwg www      wwww
                 www          w  wwww          wwr            ww
                 www               ww                         ww
                   ww     wwww           gwwww                  
                   wwww     ww   ww   ww rwwww        wwww      
wg       ww      w  ww gww       ww   ww                        
wr      www         wwwrww       ww   ww       w                
        www           w    ww         ww   ww ww                
        www                           ww   ww              w    
        www  w     w            ww                ww       w    
          ww ww    w        ww                   www  ww   w www
                   w                     www     www         www
ww                 w                ww   www     ww             
                            ww           www        w           
      w       ww                         ww        ww           
      w                 w ww        wwww           ww           
   w  w                 w           ww      www   w             
   w                                        www         ww      
    w                                                   ww      
    w                                                           
                                                                
          w                                          w    www   
          w     ww                       www      w       wwwww 
                                         www    w w             
                          w  w  ww       www    w w             
                w    w    w  ww ww         www ww               
         ww    ww    w       ww        w   wwwww                
       www     ww    w   gw            w   www w   ww  w        
       www     gw       wr    ww       w       w   ww ww       w
   wwwwwww   wwr        w     ww    w  wwwr    w  ww  w         
   wwwwwww   ww    ww   w     ww    w  wwwgw      ww        ww  
   www  gw   ww                     w      wwww      ww   w     
   wwww rw                                 wwww       w    w    
    www                                                         
                                             ww      www        
                     wwg     ww         w    ww      www        
                     wwr                w                       
                                ww                  w           
                       w        www          w              www 
                       w        ww           w                  
